00000000000000004000000000
00700000000000000000000000
00220022002200220022002200
00220022002200220022002200
00220022002200220022002200
40220022402200220022402270
00220022002233220022002200
00220022002233220022002200
00220022002200220022002200
00220022000000000022002200
00220022000000000022002200
00700000002200220000000000
00000000002200220000000000
22002222000004000022220022
33002222000000000022220033
00000000002200220000000070
00000000002222220000000000
00220022002222220022002200
00220022002200220022002200
00220022002200220022002200
00220022002200220022002200
00220022000000000022002200
00220022000000000022002200
00220022000222200022002200
00000000000290200000000000
00000600000200200000000000