00000011000000110000000000
00000011000000110000000000
00220011000000220022002200
00220011000000220022002200
00220000040000220022112240
00227000000022220722112200
40000022000000000011000000
00000022000000000011000000
55000022000011000022552211
55000022000011000022552211
55550000002200001100550000
55550000002200001100550000
00222222555555110000552240
40222222555555110007552200
00000011552200220022002200
07000011552200220022002200
11220011002200220000002200
11220011002200220000002200
00220022002222220022002200
00220022002222220022002200
00220022002222220000000000
00220022000000000000000000
00220000000000000022002200
70220000000222200022002270
00220022000290200022222200
00220022000200206022222200