04000000220000002200000000
00000000220000002200000000
00555555220000400000000000
40555555220000000000111111
22555555000000777700000000
22555555000000000000004000
55555555000000220022222220
55555555000000220022222220
55555555222222220022000200
55555555222222000022000200
55555555000022000000000200
55555555000022000077000200
00550000000011111100005500
40550000000011111100405500
00070000000000007055555555
00220022000000000055555555
22200222200222222255555555
22200222200200000055555555
00000000002200000055555555
00000000002200222255555555
22000010000000000055555500
22000010000000000055555500
22220010000000000055555540
22220010000222200055555500
11222200000290200022000000
11222200060200200022000000