00555500000000000000005500
00555500000000000000005500
55550000002222000000440055
55554400222222222200000055
55000002222222222222000033
55000002222222222222220000
33000022222222222222222000
00000022222222222222222000
07770222000000222222002000
00000200000000002222002000
11000200344430002220007700
11000200300030002220000000
00002200000000002220001111
00002200222200002220001111
00002222222222222222000000
00002222222222222222000777
00022222222222222222200000
00022222222222222222200000
00222222222222222222220000
00000022222222222200000000
00222200222222220022220055
00222222002222002222220055
55002222000000002222005555
55000000000222200000005555
33550000000290200000555533
33550060000200200000555533