00000000222200000000000000
04400000222200000000000000
00000000220000003333330000
33002200220000000000330000
33002200000022000000004400
33002200000022000000000000
22002222220022220011110011
22002222220022220011110011
22000000220007770011000000
00000000000000000011000000
04400000111100111111002222
07702200111100111111002222
22220000112200222000000000
22220000112200222000000000
00000000110000000000033000
00000000110000000000033000
11111100110033002200030777
11111100110033002200030000
00004400000000000000032222
00000022220000000000032222
00000000222222222200000000
00000000220000002222000000
22222200000000000022220000
22220000000222200000220000
22000000000290200000007700
00000060000200200000000000